00000011111111111111111111111111111111111111111111111111111111111111111111111111111111111111111111111111111111111111111111111111111111111111111111111111
00000000000000000000000000000000000000000000000000000000000000000000000000000000000000000000000000000000000000000000000000000000000000000000000000000001
10000000000000000000000000000000000000000000000000000000000000000000000000000000000000000000000000000000000000000000000000000000000000000000000000000001
10000000000000000000000000000000000000000000000000000000000000000000000000000000000000000000000000000000000000000000000000000000000000000000000000000001
10000000000000000000000000000000000000000000000000000000000000000000000000000000000000000000000000000000000000000000000000000000000000000000000000000001
10000000000000000000000000000000000000000000000000000000000000000000000000000000000000000000000000000000000000000000000000000000000000000000000000000001
10000000000000000000000000000000000000000000000000000000000000000000000000000000000000000000000000000000000000000000000000000000000000000000000000000001
10000000000000000000000000000000000000000000000000000000000000000000000000000000000000000000000000000000000000000000000000000000000000000000000000000001
10000000000000000000000000000000000000000000000000000000000000000000000000000000000000000000000000000000000000000000000000000000000000000000000000000001
10000000000000000000000000000000000000000000000001111111100000000000000000000000000000000000000000000000000000000000000000000000011111111000000000000001
10000000000000000000000000000000000000000000000001111111100000000000000000000000000000000000000000000000000000000000000000000000011111111000000000000001
10000000000000000000000000000000000000000000000001111111100000000000000000000000000000000000000000000000000000000000000000000000011111111000000000000001
10000000000011111100000000000000000000000000000001111111100000000000000000000000000000000000111111000000000000000000000000000000011111111000000000000001
10000000000010000000000000000000000000000000000001111111100000000000000000000000000000000000100000000000000000000000000000000000011111111000000000000001
10000000000010000000000000000000000000000000000001111111100000000000000000000000000000000000100000000000000000000000000000000000011111111000000000000001
10000000000010000000000000000000000000000000000001111111100000000000000000000000000000000000100000000000000000000000000000000000011111111000000000000001
10000000000010000000000000000000000000000000000001111111100000000000000000000000000000000000100000000000000000000000000000000000011111111000000000000001
10000000000010000000000000000000000000000000000000000000000000000000000000000000000000000000100000000000000000000000000000000000000000000000000000000001
10000000000000000000000000000000000000000000000000000000000000000000000000000000000000000000000000000000000000000000000000000000000000000000000000000001
10000000000000000000000000000000000000000000000000000000000000000000000000000000000000000000000000000000000000000000000000000000000000000000000000000001
10000000000000000000000000000000000000000000000000000000000000000000000000000000000000000000000000000000000000000000000000000000000000000000000000000001
10000000000000000000000000000000000000000000000000000000000000000000000000000000000000000000000000000000000000000000000000000000000000000000000000000001
10000000000000000000000000000000000000000000000000000000000000000000000000000000000000000000000000000000000000000000000000000000000000000000000000000001
10000000000000000000000000000000000000000000000000000000000000000000000000000000000000000000000000000000000000000000000000000000000000000000000000000001
10000000000000000000000000000000000000000000000000000000000000000000000000000000000000000000000000000000000000000000000000000000000000000000000000000001
10000000000000000000000000000000000000000000000000000000000000000000000000000000000000000000000000000000000000000000000000000000000000000000000000000001
10000000000000000000000000000000000000000000000000000000000000000000000000000000000000000000000000000000000000000000000000000000000000000000000000000001
10000000000000000000000000000000000000000000000000000000000000000000000000000000000000000000000000000000000000000000000000000000000000000000000000000001
10000000000000000000000000000000000000000000000000000000000000000000000000000000000000000000000000000000000000000000000000000000000000000000000000000001
10000000000000000000000000000000000000000000000000000000000000000000000000000000000000000000000000000000000000000000000000000000000000000000000000000001
10000000000000000000000000000000000000000000000000000000000000000000000000000000000000000000000000000000000000000000000000000000000000000000000000000001
10000000000000000000000000000000000000000000000000000000000000000000000000000000000000000000000000000000000000000000000000000000000000000000000000000001
10000000000000000000000000000000000000000000000000000000000000000000000000000000000000000000000000000000000000000000000000000000000000000000000000000001
10000000000000000000000000000000000000000000000000000000000000000000000000000000000000000000000000000000000000000000000000000000000000000000000000000001
10000000000000000000000000000000000000000000000000000000000000000000000000000000000000000000000000000000000000000000000000000000000000000000000000000001
10000000000000000000000000000000000000000000000000000000000000000000000000000000000000000000000000000000000000000000000000000000000000000000000000000001
10000000000000000000000000000000000000000000000000000000000000000000000000000000000000000000000000000000000000000000000000000000000000000000000000000001
10000000000000000000000000000000000000000000000000000000000000000000000000000000000000000000000000000000000000000000000000000000000000000000000000000001
10000000000000000000000000000000000000000000000000000000000000000000000000000000000000000000000000000000000000000000000000000000000000000000000000000001
10000000000000000000000000000000000000000000000000000000000000000000000000000000000000000000000000000000000000000000000000000000000000000000000000000001
10000000000000000000000000000000000000000000000000000000000000000000000000000000000000000000000000000000000000000000000000000000000000000000000000000001
10000000000000000000000000000000000000000000000000000000000000000000000000000000000000000000000000000000000000000000000000000000000000000000000000000001
10000000000000000000000000000000000000000000000000000000000000000000000000000000001000001111111111111111111000000000000000000000000000000000000000000001
10000000000000000000000000000000000000000000000000000000000000000000000000000000001000000000000000000000001000000000000000000000000000000000000000000001
10000000000000000000000000000000000000000000000000000000000000000000000000000000001000000000000000000000001000000000000000000000000000000000000000000001
10000000000000000000000000000000000000000000000000000000000000000000000000000000001000000000000000000000001000000000000000000000000000000000000000000001
10000000000000000000000000000000000000000000000000000000000000000000000000000000001000000000000000000000001000000000000000000000000010000000000000000001
10000000000000000000000000000000000000000000000000000000000000000000000000000000001000000000000000000000001000000000000000000000000010000000000000000001
10000000000000000000000000000000000000000000000000000000000000000000000000000000001000000000000000000000001000000000000000000000000010000000000000000001
10000000011111111000000000000000000000000000000000000000000000000000000000000000001000000000000000000000001000000000000000000000000010000000000000000001
10000000011111111000000000000000000000000000000000000000000000000000000000000000001000000000000000000000001000000000000000000000000010000000000000000001
10000000011111111000000000000000000000000000000000000000000000000000000000000000001000000000000000000000001000000000000000000000000010000000000000000001
10000000011111111000000000000000000000000000000000001111110000000000000000000000001000000000000000000000001000000000000000000000000011111100000000000001
10000000011111111000000000000000000000000000000000001000000000000000000000000000001111111111111111111111111000000000000000000000000000000000000000000001
10000000011111111000000000000000000000000000000000001000000000000000000000000000000000000000000000000000000000000000000000000000000000000000000000000001
10000000011111111000000000000000000000000000000000001000000000000000000000000000000000000000000000000000000000000000000000000000000000000000000000000001
10000000011111111000000000000000000000000000000000001000000000000000000000000000000000000000000000000000000000000000000000000000000000000000000000000001
10000000000000000000000000000000000000000000000000001000000000000000000000000000000000000000000000000000000000000000000000000000000000000000000000000001
10000000000000000000000000000000000000000000000000000000000000000000000000000000000000000000000000000000000000000000000000000000000000000000000000000001
10000000000000000000000000000000000000000000000000000000000000000000000000000000000000000000000000000000000000000000000000000000000000000000000000000001
10000000000000000000000000000000000000000000000000000000000000000000000000000000000000000000000000000000000000000000000000000000000000000000000000000001
10000000000000000000000000000000000000000000000000000000000000000000000000000000000000000000000000000000000000000000000000000000000000000000000000000001
10000000000000000000000000000000000000000000000000000000000000000000000000000000000000000000000000000000000000000000000000000000000000000000000000000001
10000000000000000000000000000000000000000000000000000000000000000000000000000000000000000000000000000000000000000000000000000000000000000000000000000001
10000000000000000000000000000000000000000000000000000000000000000000000000000000000000000000000000000000000000000000000000000000000000000000000000000001
10000000000000000000000000000000000000000000000000000000000000000000000000000000000000000000000000000000000000000000000000000000000000000000000000000001
10000000000000000000000000000000000000000000000000000000000000000000000000000000000000000000000000000000000000000000000000000000000000000000000000000001
10000000000000000000000000000000000000000000000000000000000000000000000000000000000000000000000000000000000000000000000000000000000000000000000000000001
10000000000000000000000000000000000000000000000000000000000000000000000000000000000000000000000000000000000000000000000000000000000000000000000000000001
10000000000000000000000000000000000000000000000000000000000000000000000000000000000000000000000000000000000000000000000000000000000000000000000000000001
10000000000000000000000000000000000000000000000000000000000000000000000000000000000000000000000000000000000000000000000000000000000000000000000000000001
10000000000000000000000000000000000000000000000000000000000000000000000000000000000000000000000000000000000000000000000000000000000000000000000000000001
10000000000000000000000000000000000000000000000000000000000000000000000000000000000000000000000000000000000000000000000000000000000000000000000000000001
10000000000000000000000000000000000000000000000000000000000000000000000000000000000000000000000000000000000000000000000000000000000000000000000000000001
10000000000000000000000000000000000000000000000000000000000000000000000000000000000000000000000000000000000000000000000000000000000000000000000000000001
10000000000000000000000000000000000000000000000000000000000000000000000000000000000000000000000000000000000000000000000000000000000000000000000000000001
10000000000000000000000000000000000000000000000000000000000000000000000000000000000000000000000000000000000000000000000000000000000000000000000000000001
10000000000000000000000000000000000000000000000000000000000000000000000000000000000000000000000000000000000000000000000000000000000000000000000000000001
10000000000000000000000000000000000000000000000000000000000000000000000000000000000000000000000000000000000000000000000000000000000000000000000000000001
10000000000000000000000000000000000000000000000000000000000000000000000000000000000000000000000000000000000000000000000000000000000000000000000000000001
10000000000000000000000000000000000000000000000000000000000000000000000000000000000000000000000000000000000000000000000000000000000000000000000000000001
10000000000000000000000000000000000000000000000000000000000000000000000000000000000000000000000000000000000000000000000000000000000000000000000000000001
10100000111111111111111111100000000000000011111111111100000111111110000000000000000000000000000000000000000000000000000000000000000000000000000000000001
10100000000000000000000000100000000000000010000000000100000000000010000000000000000000000000000000000000000000000000000000000000000000000000000000000001
10100000000000000000000000100000000000000010000000000100000000000010000000000000000000000000000000000000000000000000000000000000000000000000000000000001
10100000000000000000000000100000000000000010000000000100000000000010000000000000000000000000000000000000000000000000000000000000000000000000000000000001
10100000000000000000000000100000000000000010000000000100000000000010000000000000000000000000000000000000000000000000000000000000000010000000000000000001
10100000000000000000000000100000000000000010000000000000000000000010000000000000000000000000000000000000000000000000000000000000000010000000000000000001
10100000000000000000000000100000000000000010000000000000000000000010000000000000000000000000000000000000000000000000000000000000000010000000000000000001
10100000000000000000000000100000000000000010000000000000000000000010000000000000000000000000000000000000000000000000000000000000000010000000000000000001
10100000000000000000000000100000000000000010000000000000000000000010000000000000000000000000000000000000000000000000000000000000000010000000000000000001
10100000000000000000000000100000000000000010000000000000000000000010000000000000000000000000000000000000000000000000000000000000000010000000000000000001
10100000000000000000000000100000000000000010000000000000000000000010000000000000000000000000111111000000000000000000000000000000000011111100000000000001
10100000000000000000000000100000000000000010000000000000000000000010000000000000000000000000100000000000000000000000000000000000000000000000000000000001
10100000000000000000000000100000000000000010000000000000000000000010000000000000000000000000100000000000000000000000000000000000000000000000000000000001
10100000000000000000000000100000000000000010000000000000000000000010000000000000000000000000100000000000000000000000000000000000000000000000000000000001
10111111111111111111111111100000000000000010000000000000000000000010000000000000000000000000100000000000000000000000000000000000000000000000000000000001
10000000000000000000000000000000000000000010000000000000000000000010000000000000000000000000100000000000000000000000000000000000000000000000000000000001
10000000000000000000000000000000000000000010000000000000000000000010000000000000000000000000000000000000000000000000000000000000000000000000000000000001
10000000000000000000000000000000000000000010000000000000000000000010000000000000000000000000000000000000000000000000000000000000000000000000000000000001
10000000000000000000000000000000000000000010000000000000000000000010000000000000000000000000000000000000000000000000000000000000000000000000000000000001
10000000000000000000000000000000000000000010000000000000000000000010000000000000000000000000000000000000000000000000000000000000000000000000000000000001
10000000000000000000000000000000000000000010000000000000000000000010000000000000000000000000000000000000000000000000000000000000000000000000000000000001
10000000000000000000000000000000000000000010000000000000000000000010000000000000000000000000000000000000000000000000000000000000000000000000000000000001
10000000000000000000000000000000000000000010000000000000000000000010000000000000000000000000000000000000000000000000000000000000000000000000000000000001
10000000000000000000000000000000000000000010000000000000000000000010000000000000000000000000000000000000000000000000000000000000000000000000000000000001
10000000000000000000000000000000000000000011111111111111111111111110000000000000000000000000000000000000000000000000000000000000000000000000000000000001
10000000000000000000000000000000000000000000000000000000000000000000000000000000000000000000000000000000000000000000000000000000000000000000000000000001
10000000000000000000000000000000000000000000000000000000000000000000000000000000000000000000000000000000000000000000000000000000000000000000000000000001
10000000000000000000000000000000000000000000000000000000000000000000000000000000000000000000000000000000000000000000000000000000000000000000000000000001
10000000000000000000000000000000000000000000000000000000000000000000000000000000000000000000000000000000000000000000000000000000000000000000000000000001
10000000000000000000000000000000000000000000000000000000000000000000000000000000000000000000000000000000000000000000000000000000000000000000000000000001
10000000000000000000000000000000000000000000000000000000000000000000000000000000000000000000000000000000000000000000000000000000000000000000000000000001
10000000000000000000000000000000000000000000000000000000000000000000000000000000000000000000000000000000000000000000000000000000000000000000000000000001
10000000000000000000000000000000000000000000000000000000000000000000000000000000000000000000000000000000000000000000000000000000000000000000000000000001
10000000000000000000000000000000000000000000000000000000000000000000000000000000000000000000000000000000000000000000000000000000000000000000000000000001
10000000000000000000000000000000000000000000000000000000000000000000000000000000000000000000000000000000000000000000000000000000000000000000000000000001
10000000000000000000000000000000000000000000000000000000000000000000000000000000000000000000000000000000000000000000000000000000000000000000000000000001
10000000000000000000000000000000000000000000000000000000000000000000000000000000000000000000000000000000000000000000000000000000000000000000000000000001
10000000000000000000000000000000000000000000000000000000000000000000000000000000000000000000000000000000000000000000000000000000000000000000000000000001
10000000000000000000000000000000000000000000000000000000000000000000000000000000000000000000000000000000000000000000000000000000000000000000000000000001
10000000000000000000000000000000000000000000000000000000000000000000000000000000000000000000000000000000000000000000000000000000000000000000000000000001
10100000111111111111111111100000000000000000000000000000000000000000000000000000001000001111111111111111111000000000000000000000000000000000000000000001
10100000000000000000000000100000000000000000000000000000000000000000000000000000001000000000000000000000001000000000000000000000000000000000000000000001
10100000000000000000000000100000000000000000000000000000000000000000000000000000001000000000000000000000001000000000000000000000000000000000000000000001
10100000000000000000000000100000000000000000000000000000000000000000000000000000001000000000000000000000001000000000000000000000000000000000000000000001
10100000000000000000000000100000000000000000000000000000000000000000000000000000001000000000000000000000001000000000000000000000000000000000000000000001
10100000000000000000000000100000000000000000000000000000000000000000000000000000001000000000000000000000001000000000000000000000000000000000000000000001
10100000000000000000000000100000000000000000000000000000000000000000000000000000001000000000000000000000001000000000000000000000000000000000000000000001
10100000000000000000000000100000000000000000000000000000000000000000000000000000001000000000000000000000001000000000000000000000011111111000000000000001
10100000000000000000000000100000000000000000000000000000000000000000000000000000001000000000000000000000001000000000000000000000011111111000000000000001
10100000000000000000000000100000000000000000000000000000000000000000000000000000001000000000000000000000001000000000000000000000011111111000000000000001
10100000000000000000000000100000000000000000000000001111110000000000000000000000001000000000000000000000001000000000000000000000011111111000000000000001
10100000000000000000000000100000000000000000000000001000000000000000000000000000001111111111111111111111111000000000000000000000011111111000000000000001
10100000000000000000000000100000000000000000000000001000000000000000000000000000000000000000000000000000000000000000000000000000011111111000000000000001
10100000000000000000000000100000000000000000000000001000000000000000000000000000000000000000000000000000000000000000000000000000011111111000000000000001
10111111111111111111111111100000000000000000000000001000000000000000000000000000000000000000000000000000000000000000000000000000011111111000000000000001
10000000000000000000000000000000000000000000000000001000000000000000000000000000000000000000000000000000000000000000000000000000000000000000000000000001
10000000000000000000000000000000000000000000000000000000000000000000000000000000000000000000000000000000000000000000000000000000000000000000000000000001
10000000000000000000000000000000000000000000000000000000000000000000000000000000000000000000000000000000000000000000000000000000000000000000000000000001
10000000000000000000000000000000000000000000000000000000000000000000000000000000000000000000000000000000000000000000000000000000000000000000000000000001
10000000000000000000000000000000000000000000000000000000000000000000000000000000000000000000000000000000000000000000000000000000000000000000000000000001
10000000000000000000000000000000000000000000000000000000000000000000000000000000000000000000000000000000000000000000000000000000000000000000000000000001
10000000000000000000000000000000000000000000000000000000000000000000000000000000000000000000000000000000000000000000000000000000000000000000000000000001
10000000000000000000000000000000000000000000000000000000000000000000000000000000000000000000000000000000000000000000000000000000000000000000000000000001
10000000000000000000000000000000000000000000000000000000000000000000000000000000000000000000000000000000000000000000000000000000000000000000000000000001
10000000000000000000000000000000000000000000000000000000000000000000000000000000000000000000000000000000000000000000000000000000000000000000000000000001
10000000000000000000000000000000000000000000000000000000000000000000000000000000000000000000000000000000000000000000000000000000000000000000000000000001
10000000000000000000000000000000000000000000000000000000000000000000000000000000000000000000000000000000000000000000000000000000000000000000000000000001
10000000000000000000000000000000000000000000000000000000000000000000000000000000000000000000000000000000000000000000000000000000000000000000000000000001
10000000000000000000000000000000000000000000000000000000000000000000000000000000000000000000000000000000000000000000000000000000000000000000000000000001
11111111111111111111111111111111111111111111111111111111111111111111111111111111111111111111111111111111111111111111111111111111111111111111111111111111
